[OVERLAY]
┌──────┐
│ あたま  │
│  ゛ ゛ │
│ みきうて │
│  ゛  ゛│
│ ひたリうて│
│    ゛ │
│ きゃくふ │
│      │
│ やめる  │
└──────┘