[OVERLAY]
┌────────────────┐
│                │
│                │
│                │
│                │
│                │
│                │
│                │
│                │
└────────────────┘