[OVERLAY]
x========+
/        ‾
/        ‾
/        ‾
/        ‾
/        ‾
/        ‾
/        ‾
/ ランク    ‾
/  ゛     ‾
/ レヘル    ‾
♥







\x4f
/        ‾
/        ‾
/        ‾
/        ‾
円\x7d\x7d\x7d\x7d\x7d\x7d\x7d\x7d\x7e
