[OVERLAY]
│                ゛ │
│ しょうリつ       わリ ふ │
│ ゜                │
│ ハーツ         /240 │
│ ゜  ゛             │
│ フレイしかん     00\x7d00 │
└──────────────────┘