[OVERLAY]
┌─────────┐
│ ステータスをみる│
│         │
│ せんとうかいし │
│  ゛      │
│ もとる     │
└─────────┘