[OVERLAY]
┌──────┐
│  ゛   │
│ メタロット│
│  ゛   │
│ メタル  │
│ ゜    │
│ ハーツ  │
│  ゛   │
│ としる  │
└──────┘