[OVERLAY]
┌──────────────────┐
│                  │
│                  │
│                  │
│                  │
│                  │
│                  │
└──────────────────┘