[OVERLAY]
x========+
/ランク     ‾
/ ゛      ‾
/レヘル     ‾
/        ‾
/けいけんち   ‾
/        ‾
/ あと     ‾
♥







\x4F
/  ゛     ‾
/こうけき    ‾
/゛ ゛     ‾
/ほうきょ    ‾
/        ‾
/とくしゅ    ‾
/        ‾
/あいしょう   ‾
円\x7D\x7D\x7D\x7D\x7D\x7D\x7D\x7D\x7E
