[OVERLAY]
x========+
/ ゛      ‾
/なくる     ‾
/゛       ‾
/かむしゃら   ‾
/        ‾
/うつ      ‾
/        ‾
/ねらいうち   ‾
/        ‾
/おうえん    ‾
/        ‾
/まもる     ‾
/        ‾
/なおす     ‾
/        ‾
/そのほか    ‾
円\x7D\x7D\x7D\x7D\x7D\x7D\x7D\x7D\x7E
