[OVERLAY]
┌──────────────────┐
│    ゛  ゛          │
│セレクトホタンて いれかえます   │
│                  │
│                  │
└──────────────────┘