[OVERLAY]
┌──────────────────┐
│                  │
│いくつ?      コ    00円│
│     ゛            │
│もってるかす    コ       │
└──────────────────┘