[OVERLAY]
                    
 ┌─── つうしんメニュー ───┐ 
 │                │ 
 │                │ 
 │                │ 
 │                │ 
 │                │ 
 │                │ 
 │                │ 
 │                │ 
 │                │ 
 │                │ 
 │                │ 
 │                │ 
 │                │ 
 │                │ 
 └────────────────┘ 
                    