[OVERLAY]
┌──────────────────┐
│                  │
│Head              │
│                  │
│R-Arm             │
│                  │
│L-Arm             │
│                  │
│Legs              │
└──────────────────┘
