[OVERLAY]
                    
 ┌─── Link Menu───┐ 
 │                │ 
 │                │ 
 │                │ 
 │                │ 
 │                │ 
 │                │ 
 │                │ 
 │                │ 
 │                │ 
 │                │ 
 │                │ 
 │                │ 
 │                │ 
 │                │ 
 └────────────────┘ 
                    