[OVERLAY]
┌──────────────┐
│ ゛  ゛         │
│ テータかこわれています  │
│ ゛            │
│ テータをクリアします   │
│             ▽│
└──────────────┘