[OVERLAY]
┌──────────────────┐
│                  │
│ なまえ              │
│                  │
│ かち        まけ     │