[OVERLAY]
┌──────────────────┐
│                  │
│Head              │
│                  │
│RArm              │
│                  │
│LArm              │
│                  │
│Legs              │
└──────────────────┘
