[OVERLAY]
┌──────────────────┐
│ ゛  ゛ ゛ ゜ ゛       │
│みき・ひたリて ヘーシきリかえ   │
│                  │
│                  │
└──────────────────┘