[OVERLAY]
└──────────────────┘
┌──────────────────┐
│                  │
│Save completed.   │
│                  │
│                  │
└──────────────────┘
