[OVERLAY]
┌─────────┐
│         │
│         │
│         │
│         │
│         │
│         │
│         │
│         │
└─────────┘